1111111111111111
1000000001000001
1000000001000001
1000000000000001
1111110000000001
1000000000000001
1000000000011111
1000010000000001
1000010000000001
1000010000000004
1000010000000001
1111111111111111