112111111111
100000000001
100000000001
111111000001
100000000001
100000000001
100000000071
100001111111
100001003001
100001000001
100000000001
100000000001
100010001111
100010000001
100010000001
111111114111

111111116111
100000002001
100011111111
100010000081
100010000001
100010000101
100000000101
111111100101
100000000101
130000000101
100001111101
100000000001
100010001111
100010000001
100010000001
114111111111

111111611111
100010200001
100010000001
130010000001
100010000001
100010000001
100011111001
100000000001
100010000001
100010030001
100011111001
100010000001
100013111111
100011100001
100000000001
111111111511

