1111111111111111
1000000000000001
1200000000000001
1000000000000001
1000000000000001
1000000000000001
1000000000000001
1000000000000001
1000000000000001
1000000000000004
1000000000000001
1111111111111111
